"filename", "language", "Dart", "comment", "blank", "total"
"c:\Dev\car_rental\lib\constants.dart", "Dart", 1, 0, 1, 2
"c:\Dev\car_rental\lib\core\countries.dart", "Dart", 247, 0, 1, 248
"c:\Dev\car_rental\lib\core\errors\failure.dart", "Dart", 42, 0, 7, 49
"c:\Dev\car_rental\lib\core\helper_functions\on_generate_route.dart", "Dart", 50, 0, 5, 55
"c:\Dev\car_rental\lib\core\helper_functions\show_bars.dart", "Dart", 10, 0, 2, 12
"c:\Dev\car_rental\lib\core\models\auth_response_model.dart", "Dart", 129, 0, 22, 151
"c:\Dev\car_rental\lib\core\services\custom_bloc_observer.dart", "Dart", 19, 0, 4, 23
"c:\Dev\car_rental\lib\core\services\data_service.dart", "Dart", 0, 0, 2, 2
"c:\Dev\car_rental\lib\core\services\get_it_service.dart", "Dart", 11, 0, 3, 14
"c:\Dev\car_rental\lib\core\services\quent_auth_service.dart", "Dart", 135, 1, 23, 159
"c:\Dev\car_rental\lib\core\utils\app_text_styles.dart", "Dart", 23, 0, 2, 25
"c:\Dev\car_rental\lib\core\widgets\custom_button.dart", "Dart", 39, 0, 5, 44
"c:\Dev\car_rental\lib\core\widgets\custom_text_form_field.dart", "Dart", 50, 0, 6, 56
"c:\Dev\car_rental\lib\core\widgets\forgot_password.dart", "Dart", 47, 0, 7, 54
"c:\Dev\car_rental\lib\core\widgets\or_divider.dart", "Dart", 21, 0, 4, 25
"c:\Dev\car_rental\lib\core\widgets\password_field.dart", "Dart", 38, 1, 6, 45
"c:\Dev\car_rental\lib\core\widgets\social_login_button.dart", "Dart", 50, 0, 5, 55
"c:\Dev\car_rental\lib\features\auth\cubits\cubit\get_locations_cubit.dart", "Dart", 21, 0, 6, 27
"c:\Dev\car_rental\lib\features\auth\cubits\cubit\get_locations_state.dart", "Dart", 13, 0, 8, 21
"c:\Dev\car_rental\lib\features\auth\cubits\get_countries\get_countries_cubit.dart", "Dart", 22, 0, 7, 29
"c:\Dev\car_rental\lib\features\auth\cubits\get_countries\get_countries_state.dart", "Dart", 13, 0, 8, 21
"c:\Dev\car_rental\lib\features\auth\cubits\reset_password\reset_password_cubit.dart", "Dart", 53, 0, 10, 63
"c:\Dev\car_rental\lib\features\auth\cubits\reset_password\reset_password_state.dart", "Dart", 18, 0, 11, 29
"c:\Dev\car_rental\lib\features\auth\cubits\sign_in\sign_in_cubit.dart", "Dart", 21, 0, 7, 28
"c:\Dev\car_rental\lib\features\auth\cubits\sign_in\sign_in_state.dart", "Dart", 13, 0, 8, 21
"c:\Dev\car_rental\lib\features\auth\cubits\sign_up\sign_up_cubit.dart", "Dart", 37, 0, 7, 44
"c:\Dev\car_rental\lib\features\auth\cubits\sign_up\sign_up_state.dart", "Dart", 13, 0, 8, 21
"c:\Dev\car_rental\lib\features\auth\domain\data\repos\auth_repo_impl.dart", "Dart", 102, 0, 15, 117
"c:\Dev\car_rental\lib\features\auth\domain\entities\country_entity.dart", "Dart", 17, 0, 3, 20
"c:\Dev\car_rental\lib\features\auth\domain\entities\location_entity.dart", "Dart", 20, 0, 3, 23
"c:\Dev\car_rental\lib\features\auth\domain\entities\request_password_reset_code_entity.dart", "Dart", 15, 0, 3, 18
"c:\Dev\car_rental\lib\features\auth\domain\entities\reset_password_entity.dart", "Dart", 7, 0, 3, 10
"c:\Dev\car_rental\lib\features\auth\domain\entities\user_entity.dart", "Dart", 7, 0, 3, 10
"c:\Dev\car_rental\lib\features\auth\domain\repos\auth_repo.dart", "Dart", 32, 0, 7, 39
"c:\Dev\car_rental\lib\features\auth\presentation\views\new_passwrod_view.dart", "Dart", 10, 0, 2, 12
"c:\Dev\car_rental\lib\features\auth\presentation\views\reset_your_password_view.dart", "Dart", 21, 0, 4, 25
"c:\Dev\car_rental\lib\features\auth\presentation\views\sign_in_view.dart", "Dart", 19, 0, 5, 24
"c:\Dev\car_rental\lib\features\auth\presentation\views\sign_up_view.dart", "Dart", 25, 0, 5, 30
"c:\Dev\car_rental\lib\features\auth\presentation\views\verification_code_view.dart", "Dart", 10, 0, 4, 14
"c:\Dev\car_rental\lib\features\auth\presentation\views\verify_reset_password_code_view.dart", "Dart", 12, 0, 2, 14
"c:\Dev\car_rental\lib\features\auth\presentation\views\verify_your_phone_number_view.dart", "Dart", 12, 0, 4, 16
"c:\Dev\car_rental\lib\features\auth\presentation\views\widgets\CustomOtpTextFormField.dart", "Dart", 55, 0, 5, 60
"c:\Dev\car_rental\lib\features\auth\presentation\views\widgets\country_drop_down_page.dart", "Dart", 122, 0, 15, 137
"c:\Dev\car_rental\lib\features\auth\presentation\views\widgets\custom_check_box.dart", "Dart", 41, 0, 5, 46
"c:\Dev\car_rental\lib\features\auth\presentation\views\widgets\custom_pick_country.dart", "Dart", 68, 0, 9, 77
"c:\Dev\car_rental\lib\features\auth\presentation\views\widgets\dont_have_an_account.dart", "Dart", 43, 0, 5, 48
"c:\Dev\car_rental\lib\features\auth\presentation\views\widgets\have_an_account.dart", "Dart", 42, 0, 5, 47
"c:\Dev\car_rental\lib\features\auth\presentation\views\widgets\location_search_bar_suggetions.dart", "Dart", 144, 1, 14, 159
"c:\Dev\car_rental\lib\features\auth\presentation\views\widgets\new_password_body_bloc_consumer.dart", "Dart", 29, 0, 4, 33
"c:\Dev\car_rental\lib\features\auth\presentation\views\widgets\new_password_view_body.dart", "Dart", 106, 0, 7, 113
"c:\Dev\car_rental\lib\features\auth\presentation\views\widgets\otp_form.dart", "Dart", 49, 0, 7, 56
"c:\Dev\car_rental\lib\features\auth\presentation\views\widgets\reset_your_password_bloc_view_body_bloc_consumer.dart", "Dart", 50, 0, 4, 54
"c:\Dev\car_rental\lib\features\auth\presentation\views\widgets\reset_your_password_view_body.dart", "Dart", 135, 0, 9, 144
"c:\Dev\car_rental\lib\features\auth\presentation\views\widgets\search_bar_suggestions.dart", "Dart", 149, 1, 15, 165
"c:\Dev\car_rental\lib\features\auth\presentation\views\widgets\sign_in_view_body.dart", "Dart", 109, 0, 7, 116
"c:\Dev\car_rental\lib\features\auth\presentation\views\widgets\sign_in_view_body_bloc_consumer.dart", "Dart", 28, 0, 4, 32
"c:\Dev\car_rental\lib\features\auth\presentation\views\widgets\sign_up_view_body.dart", "Dart", 144, 3, 8, 155
"c:\Dev\car_rental\lib\features\auth\presentation\views\widgets\sign_up_view_body_bloc_consumer.dart", "Dart", 32, 0, 5, 37
"c:\Dev\car_rental\lib\features\auth\presentation\views\widgets\verification_code_view_body.dart", "Dart", 52, 0, 3, 55
"c:\Dev\car_rental\lib\features\auth\presentation\views\widgets\verify_reset_password_code_view_body.dart", "Dart", 106, 0, 6, 112
"c:\Dev\car_rental\lib\features\auth\presentation\views\widgets\verify_reset_password_code_view_body_bloc_consumer.dart", "Dart", 16, 0, 3, 19
"c:\Dev\car_rental\lib\features\auth\presentation\views\widgets\verify_your_phone_number_view_body.dart", "Dart", 70, 0, 7, 77
"c:\Dev\car_rental\lib\features\home\presentation\views\home_view.dart", "Dart", 10, 0, 4, 14
"c:\Dev\car_rental\lib\features\home\presentation\views\widgets\home_view_body.dart", "Dart", 46, 2, 5, 53
"c:\Dev\car_rental\lib\features\on_boarding\presentation\views\on_boarding_view.dart", "Dart", 10, 0, 4, 14
"c:\Dev\car_rental\lib\features\on_boarding\presentation\views\widgets\on_boarding_page_view.dart", "Dart", 30, 0, 5, 35
"c:\Dev\car_rental\lib\features\on_boarding\presentation\views\widgets\on_boarding_view_body.dart", "Dart", 88, 0, 10, 98
"c:\Dev\car_rental\lib\features\on_boarding\presentation\views\widgets\page_view_item.dart", "Dart", 87, 0, 9, 96
"c:\Dev\car_rental\lib\generated\assets.dart", "Dart", 153, 1, 2, 156
"c:\Dev\car_rental\lib\main.dart", "Dart", 25, 1, 4, 30
"Total", "-", 3484, 11, 438, 3933